arise - arose - arisen - pojawić się
awake - awoke - awoken - obudzić
be - was, were - been - być
bear - bore - born,borne - nieść, przenosić
beat - beat - beaten - bić
become - became - become - stawać się, zostawać
begin - began - begun - zaczynać
bend - bent - bent - zginać, pochylić
bet - bet - bet - grać, postawić na coś/kogoś
bind - bound - bound - wiązać, złączyć
bite - bit - bitten - ugryźć, ukąsić
bleed - bled - bled - krwawić
blow - blew - blown - dmuchać, wiać
break - broke - broken - łamać, pękać, tłuc
breed - bred - bred - hodować, wychować
bring - brought - brought - przynosić, przyprowadzać
broadcast - broadcast - broadcast - transmitować, nadawać
build - built - built - budować
burn - burnt/burned - burnt/burned - spalić, palić
burst - burst - burst - wybuchnąc, pęknąć
buy - bought - bought - kupować
can - could - been able to - umieć, potrafić
cast - cast - cast - rzucić, zrzucić
catch - caught - caught - łapać
choose - chose - chosen - wybierać
cling - clung - clung - przywrzeć, uczepić się
come - came - come - przyjść, przyjechać
cost - cost - cost - kosztować
creep - crept - crept - skradać się, zakradać się, podchodzić
cut - cut - cut - ciąć, kroić, skaleczyć
deal - dealt - dealt - zajmować się
dig - dug - dug - kopać
do - did - done - robić
draw - drew - drawn - rysować
dream  - dreamed,dreamt - dreamed,dreamt - śnić, marzyć
drink - drank - drunk - pić
drive - drove - driven - prowadzić
eat - ate - eaten - jeść
fall - fell - fallen - spadać, padać
feed - felt - felt - karmić
fight - fought - fought - walczyć
find - found - found - znaleźć
flee - fled - fled - uciec, umknąć
fling - flung - flung - rzucić
fly - flew - flown - latać
forbid - forbade - forbidden - zakazać
foretell - foretold - foretold - przepowiadać, przewidywać
forget - forgot - forgotten - zapomnieć
forgive - forgave - forgiven - wybaczyć
forsake - forsook - forsaken - porzucić, opuścić
freeze - froze - frozen - zamarzać
get - got - got - dostawać
give - gave - given - dawać
go - went - gone - iść
grind - ground - ground - zemleć, zgrzytać, ostrzyć
grow - grew - grown - rosnąć
have - had - had - mieć
hang - hung - hung - powiesić
hear - heard - heard - słyszeć
hide - hid - hidden - chować
hit - hit - hit - uderzać
hold - held - held - trzymać, posiadać
hurt - hurt - hurt - ranić, boleć
keep - kept - kept - trzymać
kneel - knelt, kneeled - knelt, kneeled - klękać
knit - knit, knitted - knit, knitted - robić na drutach
lay - laid - laid - położyć, ułożyć
lead - led - led - prowadzić
lean - leaned/leant - leaned/leant - wychylić, przechylić
leap - leapt, leaped - leapt, leaped - skakać
learn - learnt, learned - learnt, learned - uczyć się
leave - left - left - opuścić, zostawiać
lend - lent - lent - pożyczać
let - let - let - pozwolić
lie - lay - lain - leżeć
light - lit - lit - zapalać
lose - lost - lost - zgubić
make - made - made - robić
mean - meant - meant - znaczyć, mieć na myśli
meet - met - met - spotykać
misunderstand - misunderstood - misunderstood - źle zrozumieć
pay - paid - paid - płacić
put - put - put - kłaść
quit - quit - quit - rzucać, opuszczać
read - read - read - czytać
ride - rode - ridden - jeżdzić
ring - rang - rung - dzwonić
rise - rose - risen - wzrosnąć, podnieść się
run - ran - run - biec
saw - sawed - sawn - piłować
say - said - said - mówić
see - saw - seen - zobaczyć
seek - sought - sought - szukać
sell - sold - sold - sprzedać
send - sent - sent - wysyłać
set - set - set - ustawiać, umieścić
shake - shook - shaken - potrząsnąć, trząść się
shed - shed - shed - zrzucać
shine - shone - shone -	świecić
shoot - shot - shot - strzelać
show - showed - shown - pokazywać
shrink - shrank - shrunk - kurczyć się, zbiegać
shut - shut - shut - zamykać
sing - sang - sung - śpiewać
sink - sank - sunk - tonąć
sit - sat - sat - siedzieć
slay - slew - slain - zabijać
sling - slung - slung - cisnąć, miotać
sleep - slept - slept - spać
slide - slid - slid - ślizgać się
speak - spoke - spoken - mówić
speed - sped - sped - pędzić, przyśpieszać
spell - spelt/spelled - spelt/spelled - literować
spend - spent - spent - wydawać, spędać
spill - spilt - spilt - rozlać, wylać
spin - spun - spun - kręcić
split - split - split - podzielić, rozedrzeć
spoil - spoilt - spoilt - zniszczyć
spread - spread - spread - rozchodzić się, rozkładać
spring - sprang - sprung - przeskakiwać, wyskakiwać
stand - stood - stood - stać
steal - stole - stolen - kraść
stick - stuck - stuck - przyklejać
sting - stung - stung - żądlić
stink - stank - stunk -	śmierdzieć
strike - struck - struck - uderzyć, sprawić wrażenie
strive - strove - striven - zmagać się z czymś, dążyć
swear - swore - sworn - przysięgać, kląć
sweep - swept - swept - zmiatać, zamiatać
swim - swam - swum - pływać
swing - swung - swung - machnąć, zakołysać
take - took - taken - brać
teach - taught - taught - uczyć
tear - tore - torn - podrzeć, rozedrzeć
tell - told - told - powiedzieć
think - thought - thought - myśleć, sądzić
throw - threw - thrown - rzucać
tread - trod - trodden - kroczyć, stąpać
understand - understood - understood - rozumieć
wake - woke - woken - budzić
wear - wore - worn - nosić
weep - wept - wept - płakać
win - won - won - zwycieżać
wind - wound - wound - nawijać, nakręcać
wring - wrung - wrung - wykręcić, wycisnąć
write - wrote - written - pisać
